18,16
1,1,17,12,5,9,7,1,14,4,15,15
4
2,2,4,10,4,11,4,2
7,14,7,8,9,8,9,14
11,1,11,12,13,12,13,1
15,14,15,7,16,8,16,14
